!-------MAP8--------!
++++++++++++++++++++
+------------------+
+-.-A............T-+
+-.-------Q---DD---+
+-.-------.-.....D-+
+-.-.....C.---.--Q-+
+-.-..--------.-TD-+
+-.-.N-E..T....-..-+
+-.-....-..--.-..--+
+-.-..----..-.....-+
+-.-..----..--D-DD-+
+-.-S..-T......Q.--+
+-.-...----.--.----+
+-...--.....T.....-+
+---.--..--------.-+
+-................-+
+------------------+
++++++++++++++++++++
++++++++++++++++++++
++++++++++++++++++++
++++++++++++++++++++
!-------------------!