!-------MAP---------!
++++++++++++++++++++
+##################+
+#E  ##########  P#+
+#       #        #+
+#       #        #+
+####    #     ####+
+#       #        #+
+#    ########    #+
+#    #  A   #    #+
+#    #      #    #+
+#    #      #    #+
+#  ###      ###  #+
+#   #        #   #+
+#   #        #   #+
+#                #+
+#                #+
+##################+
++++++++++++++++++++
++++++++++++++++++++
++++++++++++++++++++
++++++++++++++++++++
!-------------------!                   
