! # = Wand , leer = Boden, F = Falle, E = Eingang, A = Ausgang, * = Gegnerpfad, N = NCP, C = Checkpoint, S = Shop, Q = Quest ,  X = Quest_Exit , W = Quest_Wall , Z = Quest_Wall2 , D = Quest_Wall3 
!-------MAP---------!
++++++++++++++++++++
+##################+
+#E    F     #    #+
+#N#       Q   #  #+
+# ################+
+#                #+
+# #  ##########  #+
+# #  #      A #  #+
+# #F #    F   #  #+
+# #  #        #  #+
+# #  ####  ####  #+
+# #        Q     #+
+# # ##############+
+# # C            #+
+# ############## #+
+#          Q     #+
+##################+
++++++++++++++++++++
++++++++++++++++++++
++++++++++++++++++++
++++++++++++++++++++
!-------------------!                   
