!-------MAP---------!
++++++++++++++++++++
+##################+
+#  #   #   #   #E#+
+#    #   #   # N #+
+# ################+
+#              C #+
+################ #+
+#                #+
+#   ###          #+
+#                #+
+#                #+
+#                #+
+#        ###     #+
+#                #+
+#                #+
+#  *****         #+
+##################+
++++++++++++++++++++
++++++++++++++++++++
++++++++++++++++++++
++++++++++++++++++++
!-------------------!                   
