!-------MAP---------!
++++++++++++++++++++
+<<<<<<<<<<<<<<<<<<+
+<    ******      <+
+<                <+
+< <<< <  <<<<<   <+
+< F             F<+
+<        F       <+
+< Q              <+
+<    <<<<<       <+
+<                <+
+<ZZ<Z<<<ZZZ<Z<ZZZ<+
+< C  <<Q <<< <<  <+
+<<<  <  < F< <  <<+
+<             <  <+
+<<<<<ZZ<<<<<<<<<Z<+
+<E      N      Q <+
+<<<<<<<<<<<<<<<<<<+
++++++++++++++++++++
++++++++++++++++++++
++++++++++++++++++++
++++++++++++++++++++
!-------------------!