!-------MAP8--------!
++++++++++++++++++++
+------------------+
+-.-A............T-+
+-.-------.---..---+
+-.-------.-.....--+
+-.-.....C.---.--.-+
+-.-..--------.-T.-+
+-.-.N-E..T....-..-+
+-.-....-..--.-..--+
+-.-..----..-.....-+
+-.-..----..--.-..-+
+-.-S..-T........--+
+-.-...----.--.----+
+-...--.....T.....-+
+---.--..--------.-+
+-................-+
+------------------+
++++++++++++++++++++
++++++++++++++++++++
++++++++++++++++++++
++++++++++++++++++++
!-------------------!