!-------MAP---------!
++++++++++++++++++++
+------------------+
+-...-....T......*-+
+--.-..T.........*-+
+-..-............*-+
+-E.-...N........*-+
+-........T......*-+
+-...T...........*-+
+-..-.............-+
+-..-......T......-+
+-..-.............-+
+-....T.....C.....-+
+---.--...........-+
+-...-.........-..-+
+-..--....T.......-+
+-.....T..........-+
+------------------+
++++++++++++++++++++
++++++++++++++++++++
++++++++++++++++++++
++++++++++++++++++++
!-------------------!