!-------MAP---------!
++++++++++++++++++++
+##################+
+#  #   #   #   #E#+
+#    #   #   #   #+
+# ################+
+#                #+
+################ #+
+#                #+
+#   ###          #+
+#                #+
+#                #+
+#                #+
+#        ###     #+
+#                #+
+#                #+
+#                #+
+##################+
++++++++++++++++++++
++++++++++++++++++++
++++++++++++++++++++
++++++++++++++++++++
!-------------------!                   
