!-------MAP---------!
++++++++++++++++++++
+------------------+
+-...-....T......*-+
+--.-..T.........*-+
+-..-............*-+
+-E.-...N........*-+
+-...DDDD.T......*-+
+-...T...........*-+
+-..-Q.....DDDDDDD-+
+-..-......T......-+
+-..-.............-+
+-....T...Q.C.....-+
+---.--...........-+
+-...-.........-..-+
+-..--...QT.......-+
+-.....T..........-+
+------------------+
++++++++++++++++++++
++++++++++++++++++++
++++++++++++++++++++
++++++++++++++++++++
!-------------------!